a	a
b	b
b_inj	ɓ
c	c
d	d
d_retr	ɖ
d_inj	ɗ
e	e
f	f
g	g
g_inj	ɠ
h	h
hbis	ɦ
i	i
j	j
jbis	ʝ
k	k
l	l
l_retr	ɭ
lbis	ɺ
m	m
n	n
n_retr	ɳ
o	o
p	p
pbis	ɸ
q	q
r	r
r_retr	ɽ
rbis	ɹ
rbis_retr	ɻ
s	s
s_retr	ʂ
sbis	ɕ
t	t
t_retr	ʈ
u	u
v	v
vbis	ʋ
w	w
x	x
xbis	ɧ
y	y
z	z
z_retr	ʐ
zbis	ʑ
A	ɑ
B	β
Bbis	ʙ
C	ç
D	ð
E	ɛ
F	ɱ
G	ɣ
Gbis	ɢ
Gbis_inj	ʛ
H	ɥ
Hbis	ʜ
I	ɪ
Ibis	ᵻ
J	ɲ
Jbis	ɟ
Jbis_inj	ʄ
K	ɬ
Kbis	ɮ
L	ʎ
Lbis	ʟ
M	ɯ
Mbis	ɰ
N	ŋ
Nbis	ɴ
O	ɔ
P	ʋ
Q	ɒ
R	ʁ
Rbis	ʀ
S	ʃ
T	θ
U	ʊ
Ubis	ᵿ
V	ʌ
Vbis	ⱱ
W	ʍ
X	χ
Xbis	ħ
Y	ʏ
Z	ʒ
aro	ə
arobis	ɘ
ae	æ
u_bar	ʉ
i_bar	ɨ
o_bar	ø
E_ctr	ɜ
E_ctrbis	ɞ
r_trill	ɾ
l_tld	ɫ
a_low	ɐ
gbis	ɤ
O_bar	ɵ
oe	œ
OE	ɶ
glo	ʔ
globis	ʕ
glo_bar	ʡ
globis_bar	ʢ
clk_0	ʘ
clk	!
clk_dt	|
clk_alv	||
clk_pal	ǂ
o_nas	õ
oe_nas	œ̃
E_nas	ɛ̃
O_nas	ɔ̃
A_nas	ɑ̃
p_dent	p̪
d_dent	b̪
t_dent	t̪
d_dent	d̪
n_dent	n̪
r_trill_dent	ɾ̪
l_dent	l̪
p_h	pʰ
t_dent_h	t̪ʰ
t_h	tʰ
t_retr_h	ʈʰ
c_h	cʰ
k_h	kʰ
q_h	qʰ
pbis_h	ɸʰ
f_h	fʰ
T_h	θʰ
s_h	sʰ
S_h	ʃʰ
s_retr_h	ʂʰ
sbis_h	ɕʰ
C_h	çʰ
x_h	xʰ
X_h	χʰ
mp	m͡p
mb	m͡b
mpbis	m͡ɸ
mB	m͡β
Ff	ɱ͡f
Fv	ɱ͡v
kp	k͡p
Nkp	ᵑk͡p
gb	ɡ͡b
Ngb	ᵑɡ͡b
nt_dent	n͡t̪
nd_dent	n͡d̪
nt	n͡t
nd	n͡d
nT	n͡θ
nD	n͡ð
ns	n͡s
nz	n͡z
nS	n͡ʃ
nZ	n͡ʒ
nt_retr	ɳ͡ʈ
nd_retr	ɳ͡ɖ
Jc	ɲ͡c
JJbis	ɲ͡ɟ
Nk	ŋ͡k
Ng	ŋ͡ɡ
Nm	ŋ͡m
Nk	ŋ͡k
Ng	ŋ͡ɡ
Nbisq	ɴ͡q
NbisGbis	ɴ͡ɢ
ppbis	p͡ɸ
pf	p͡f
bB	b͡β
bv	b͡v
tT	t͡θ
ts	t͡s
tS	t͡ʃ
tsbis	t͡ɕ
ts_h	t͡sʰ
tsbis_h	t͡ɕʰ
tK	t͡ɬ
ts_retr	ʈ͡ʂ
ts_retr_h	ʈ͡ʂʰ
dD	d͡ð
dz	d͡z
dZ	d͡ʒ
dzbis	d͡ʑ
dKbis	d͡ɮ
dz_retr	ɖ͡ʐ
cC	c͡ç
Jbisjbis	ɟ͡ʝ
kx	k͡x
gG	ɡ͡ɣ
GbisR	ɢ͡ʁ
qX	q͡χ
glo_barHbis	ʡ͡ʜ
gloh	ʔ͡h
k_lab	kʷ
g_lab	gʷ
N_lab	ŋʷ
x_lab	xʷ
G_lab	ɣʷ
B_o	β̞
D_o	ð̞
l_0	l̥
b_inj_0	ɓ̥
d_inj_0	ɗ̥
Gbis_inj_0	ʛ̥
Jbis_inj_rd	ʄ̊
g_inj_rd	ɠ̊
iaro	iə
Uaro	ʊə
aroU	əʊ
Oi	ɔi
ei	ei
earo	eə
Ai	ɑi
aU	aʊ
